NO textures/tpm.png
SO textures/tpm.png
WE textures/tpm.png
EA textures/tpm.png
DOOR textures/r_door.png

F 16,125,1
C 0,81,181

        1111111111111111111111111
        1000000000110000000000001
        1011000001110000000000001
        100100000D000000000000001
111111111011000001110000000000001
10000000001100000111D111111111111
1111D111111111011100000010001
11110111111111011101010010001
11000000110101111100000010001
10000000000000000D00000010001
100000000000N0001101010010001
1100000111010101111101111000111
11110111 1110101 101111010001
11111111 1111111 111111111111
