NO textures/test/north.png
SO textures/test/south.png
WE textures/test/west.png
EA textures/test/east.png
DOOR textures/wood.png
KEY textures/wood.png

F      17,    38,     64




C 218, 234, 235

1111111111111111111111111
10S0110000100000000000001
1000110000000000111111001
10D0110000000000110001001
10K0000000100000000001001
1111111111111111111111111
