NO textures/test/north.png
SO textures/test/south.png
WE textures/test/west.png
EA textures/test/east.png
DOOR textures/tpm.png

F      17,    38,     64




C 218, 234, 235

1111111111111111111111111
10S0110000100000000000001
1000110000000000111111001
10D0110000000000110001001
1000000000100000D00001001
1111111D11111111111111111
      10000000000001     
      10000000000001     
      11111111111111     
